NO ./textures/north_texture.png
SO ./textures/south_texture.png
EA ./textures/east_texture.png
WE ./textures/west_texture.png

C 200,200,255
F 20,20, 10

111111
1010W11
111111
