WE ./textures/west_texture.png
SO ./textures/south_texture.png
NO ./textures/north_texture.png
EA ./textures/east_texture.png

C 69,255   ,   45
F 36,100   ,255

11111
10001
10N01
10001
11111
