
NO ./textures/north_texture.png

SO ./textures/south_texture.png

F       255,100,255

EA ./textures/east_texture.png
WE ./textures/west_texture.png

    C     255    ,    30,   0



  111      11 111      11111111    111
  101      11111      111111111    11
  111     11111111    11111111111
       11111000011    111000101011  1111
    1111101110011      1000001111  110011
       1111111001111   11100001111 11101
111111  1110000011     1111000111    1111
        1111100001111110000101111
        111110000000000011111101
        1111111100000S0001111111111
   111      11111111111111111
1  11  1 1 1 11111111111111
1111111
11
