
NO ./textures/north_texture.png

SO ./textures/south_texture.png

F       255,100,255

EA ./textures/east_texture.png
       WE             ./textures/west_texture.png

    C     255    ,    30,   0



11111
10001
10N01
10001
11111
