
NO ./textures/north_texture.png

SO ./textures/south_texture.png

F       255,100,255



EA ./textures/east_texture.png
       WE             ./textures/west_texture.png

    C     255    ,    30,   0

     111      11111      11111111111
     101      11111      11111111111
     111  11111111    11111111111
       11111000011    1110001010111111
    1111101110011      1000001111110011
       1111111001111   1110000111111101
111111111000001111     1111000111111111
        11111000011111110000101111
        1111100000000000011111101
        1111111100000S0001111111111
11111111111111111111111111
111111111111111111111
1111111
11