WE ./textures/west_texture.png

SO ./textures/south_texture.png

NO ./textures/north_texture.png

EA ./textures/east_texture.png


C 118,73,254
F 204,133,90

11111
10001
10N01
10001
111111111111
1
1
1
1
1
