NO ./textures/north_texture.png
SO ./textures/south_texture.png
EA ./textures/east_texture.png
WE ./textures/west_texture.png

C 200,200,255
F 20,20, 10

11111111111111111111111111111
10000000000000000000000000001
10000000000000000S00000000001
10000000000000000000000000001
11111111111111111111111111111
